tamriel = { 
	#Sea Provinces
	3355 3356 3357 3358 3359 3360 3361 3362 3363 3364 3365 3366 3367 3368 3369 3370 3371 3372 3373 3374 3375 3376 3377 3378
	3379 3380 3381 3382 3383 3384 3385 3386 3387 3388 3389 3694 3702 3703 3704 3705 3706 3740 3741 3742 3743 3744 3745 3746
	3747 3748 3749 3750 3751
	#Lakes
	3390 3391 3392 3393 3394 3395 3396 3397 3398 3399 3695 3696 3697 3698 3699 3700 3720 3721 3722 3723 3724 3725 3726

	#MORROWIND:
	#Telvanni Peninsula, North
	3068 3069 3070 3071 3072 3073 3074 3075 3076 3077 3078 3079 3080 3081 3082 3083 3084 3679 3680 3681
	#Telvanni Peninsula, South
	3082 3085 3086 3087 3088 3089 3090 3091 3092 3093 3094 3098 3682 3683
	#Akasunde and the Ebonheart Coast
	3095 3096 3106 3107 3112 3113 3114 3656 3657
	#Nezuad, Alt Orethan, Sacred Lands
	3097 3099 3100 3101 3102 3103 3105 3111 3658 3659 3660 3661
	#Kanadesit, Almalexia, Lan Orethan
	3104 3107 3108 3109 3110 3111 3115 3116 3117 3118 3119 3120 3654 3655 3718
	#Thirr Valley
	3121 3122 3123 3127 3148 3684 3716
	#Uvonaak, Pryai River, Southwest Morrowind
	3160 3161 3162 3163 3164 3165 3675 3685 3686 3687 3688 3717 3719 3731 3732
	#Veloth, Redoran Mountains, Ash Swamp, Northwest Morrowind
	3149 3150 3151 3152 3153 3154 3155 3156 3157 3158 3245 3664 3690 3691 3692 3693
	#Indaren, Eastern Valus Mountains, Armun Ashlands, Roth Roryn and Western Thirr
	3124 3125 3126 3135 3136 3137 3138 3139 3140 3141 3142 3159 3166 3167 3168 3169 3665 3689
	#Vvardenfell
	3027 3028 3029 3030 3031 3032 3033 3034 3035 3036 3037 3038 3039 3040 3041 3042 3043 3044 3045 3046 3047 3048 3049 3050 3051 3052 3053 3054 3055 3056 3057 3058 3059 3060 3061 3062 3063 3064 3065 3066 3067

	#ARGONIA:
	#Clawreach, Inner Murkwood, Central Argonia
	3182 3183 3185 3186 3187 3670 3671
	#Arnesia, Northeast Argonia
	3170 3171 3172 3173 3174 3184
	#Jer Ahkrin, Nuhyas Point, Southeastern Former Morrowind
	3128 3129 3130 3131 3132 3133 3134 3701
	#Kamanai, Shadowfen, Northwest Argonia
	3175 3176 3177 3178 3179 3180 3672 3711 3727 3728 3729 3730 3733 3734
	#Karanake, Outer Murkwood, South-Central Argonia
	3194 3195 3196 3197 3198 3712 3735 3736 3737
	#Atronium, Hankaj Coast, Eastern Argonia
	3188 3189 3190 3191 3192 3193 3208 3209 3210 3211 3212 3216 3223 3666 3667 3668 3669 3708 3709 3710
	#Hjalokh, Talu Swamps, Sikiha Coast, Southern Argonia
	3200 3201 3202 3203 3204 3205 3206 3207 3214 3215 3217 3218 3224 3225 3663 3674
	#Arkethnia, Darkmoor, Sheoth Coast, Southwestern Argonia
	3199 3219 3220 3221 3222 3226 3230 3231 3232 3233 3234 3235 3662 3707 3738
	#Seydahnil, Foxfyrn Coast, East Blackwood, Western Argonia
	3227 3228 3229 3236 3237 3238 3239 3240 3241 3673
	#Isle of Lilmothiit
	3212 3213
	#Topal Isle
	3556 3557

	#SKYRIM:
	#Northern Valus / Morrowind Border
	3244 3246 3248
	#Eastmarch
	3247 3249 3250 3251 3252 3253 3254 3255 3256 3257 3258 3312
	#The Rift
	3259 3260 3261 3262 3263 3264 3265 3266 3267 3268 3269 3270 3271 3272 3273 3274 3676
	#Winterhold & Pale
	3275 3276 3277 3278 3279 3280 3281 3282 3283 3284 3285 3286
	#Hjaalmarch
	3287 3288 3289 3301 3302 3303 3304
	#Haafingar
	3290 3291 3292 3293 3295 3296 3297 3298 3299 3300
	#Whiterun Hold
	3305 3306 3307 3308 3309 3310 3311 3313 3314 3315 3677 3678
	#Falkreath Hold
	3316 3317 3318 3319 3320 3321 3322 3323 3324 3325 3326
	#The Reach
	3294 3327 3328 3329 3330 3331 3332 3333
	#Solstheim
	3143 3144 3145 3146 3147
	
	#CYRODIIL:
	#County Leyawiin
	3181 3242 3243 3334 3335 3336 3337 3338 3339 3340 3341 3342 3343 3344 3345 3346 3347 3348 3349 3350 3351 3713 3714 3715
	#A few bits of wasteland that just happened to be added at this time
	3352 3353 3354
	#County Cheydinhal / East County Bravil
	3400 3401 3402 3403 3404 3405 3406 3407 3408 3409 3410 3411 3412 3413 3414 3415 3416 3417 3418 3419 3420 3421 3422 3423 3424 3425 3426 3427 3428 3429 3430
	#County Bruma / North Cyrodiil
	3431 3432 3433 3434 3435 3436 3437 3438 3439 3440 3441 3442 3443 3444 3445 3446 3447 3448 3449 3450 3451 3452
	#County Chorrol
	3453 3454 3455 3456
	#Heartlands east of Niben
	3457 3458 3459 3460 3461 3462 3463 3464 3465
	#County Kvatch
	3466 3467 3468 3469 3470 3471 3472 3473 3474 3475 3476
	#County Anvil
	3477 3478 3479 3480 3481 3482 3483 3484 3485 3486 3487 3488 3489 3490 3491 3492
	#County Skingrad / Heartlands west of Niben / North County Bravil
	3493 3494 3495 3496 3497 3498 3499 3500 3501 3502 3503 3504 3505 3506 3507 3508 3509 3510 3511 3512 3513 3514 3515 3516 3517 3518 3519 3520 3521 3522 3523 3524 3525 3526 3527 3528
	#City Isle
	3529 3530 3531
	#New Sea Provinces
	3532 3533 3534 3535 3536 3537 3538 3539 3540 3541
	
	#ELSWEYR:
	#Anequina
	3558 3559 3560 3561 3562 3563 3564 3565 3566 3567 3568 3569 3570 3571 3572 3573 3574 3575 3576 3577 3578
	3579 3580 3581 3582 3583 3584 3585 3586 3587 3588 3589 3590 3591 3592 3593 3594 3595 3596
	#Pellitine
	3597 3598 3599 3600 3601 3602 3603 3604 3605 3606 3607 3608 3609 3610 3611 3612 3613 3614 3615 3616 3617 3618 3619 3620
	3621 3622 3623 3624 3625 3626 3627 3628 3629 3630 3631 3632 3633 3634 3635 3636 3637 3638 3639 3640 3641 3642 3643 3644 3645 3646 3647
	3648 3649 3650 3651 3652 3653
}